//MAP CONVERTED BY dmm2tgm.py THIS HEADER COMMENT PREVENTS RECONVERSION, DO NOT REMOVE
"b" = (
/turf/closed/wall/mineral/titanium,
/area/shuttle/assault_pod)
"c" = (
/obj/structure/chair/comfy/shuttle{
	dir = 4
	},
/turf/open/floor/mineral/titanium/blue,
/area/shuttle/assault_pod)
"d" = (
/turf/open/floor/mineral/titanium/blue,
/area/shuttle/assault_pod)
"e" = (
/obj/docking_port/mobile/assault_pod{
	name = "steel rain";
	port_direction = 4;
	preferred_direction = 4
	},
/obj/machinery/door/airlock/titanium{
	name = "Assault Pod";
	req_access_txt = "106"
	},
/turf/open/floor/mineral/titanium/blue,
/area/shuttle/assault_pod)
"h" = (
/obj/machinery/computer/shuttle/syndicate/drop_pod{
	name = "assault pod control";
	req_access = list();
	req_access_txt = "106"
	},
/turf/closed/wall/mineral/titanium,
/area/shuttle/assault_pod)
"D" = (
/obj/structure/chair/comfy/shuttle,
/obj/machinery/light/directional/north,
/turf/open/floor/mineral/titanium/blue,
/area/shuttle/assault_pod)
"H" = (
/obj/structure/chair/comfy/shuttle{
	dir = 8
	},
/turf/open/floor/mineral/titanium/blue,
/area/shuttle/assault_pod)
"L" = (
/obj/structure/chair/comfy/shuttle{
	dir = 1
	},
/obj/machinery/light/directional/south,
/turf/open/floor/mineral/titanium/blue,
/area/shuttle/assault_pod)
"R" = (
/obj/machinery/door/airlock/titanium{
	name = "Assault Pod";
	req_access_txt = "106"
	},
/turf/open/floor/mineral/titanium/blue,
/area/shuttle/assault_pod)
"V" = (
/turf/template_noop,
/area/template_noop)

(1,1,1) = {"
V
b
b
R
b
b
V
"}
(2,1,1) = {"
b
b
c
d
c
b
b
"}
(3,1,1) = {"
b
c
d
H
d
c
b
"}
(4,1,1) = {"
R
d
L
h
D
d
e
"}
(5,1,1) = {"
b
H
d
c
d
H
b
"}
(6,1,1) = {"
b
b
H
d
H
b
b
"}
(7,1,1) = {"
V
b
b
R
b
b
V
"}
